TILEMAP
16 16 							-- Size of tile map in tiles
8 8 							-- Tile size & block size
images/Celeste.png 	-- Tilesheet
16 16 								-- Number of tiles in tilesheet
19 49 34 34 36 34 34 50 50 50 50 50 51 0 0 33 
34 19 49 50 50 50 51 0 0 0 0 0 0 0 0 33 
34 34 19 23 0 0 0 0 0 0 0 0 0 0 3 33 
50 50 51 0 0 0 0 0 0 0 0 0 2 23 23 33 
19 65 66 0 0 0 0 0 0 0 0 0 20 21 18 34 
35 81 82 0 0 0 0 0 0 0 0 0 0 0 49 34 
34 18 21 21 22 0 0 0 0 0 0 0 0 0 0 33 
34 51 0 0 0 0 0 0 0 0 0 0 0 0 0 33 
35 0 0 0 0 0 0 0 0 0 0 0 0 0 0 33 
51 0 0 0 0 0 0 0 0 0 0 0 0 20 18 34 
0 0 0 0 0 0 0 1 0 0 0 0 0 0 33 34 
0 0 0 0 0 0 0 17 19 0 0 0 0 0 33 34 
0 0 0 17 19 0 0 49 51 0 0 4 4 4 33 34 
18 18 18 34 35 0 0 17 19 4 4 17 18 18 34 34 
34 36 34 34 35 4 4 33 34 18 18 34 34 34 36 34 
34 34 34 34 34 18 18 18 34 34 34 34 34 34 34 34