TILEMAP
16 16 							-- Size of tile map in tiles
16 16 							-- Tile size & block size
images/fondo.png 	-- Tilesheet
3 3 								-- Number of tiles in tilesheet
1 2 2 2 2 2 2 2 2 2 2 2 2 2 2 3 
4 0 0 0 0 0 0 0 0 0 0 0 0 0 0 6 
4 0 0 0 0 0 0 0 0 0 0 0 0 0 0 6 
4 0 0 0 0 0 0 0 0 0 0 0 0 0 0 6 
4 0 0 0 5 5 5 5 5 5 5 5 5 0 0 6 
4 0 0 0 5 0 0 0 0 0 0 0 0 0 0 6 
4 0 0 0 5 5 5 5 5 5 5 5 5 0 0 6 
4 0 0 0 0 0 0 0 0 0 0 0 0 0 0 6 
4 0 0 0 0 0 0 0 0 0 0 0 0 0 0 6 
4 0 0 0 5 5 5 5 5 5 5 5 5 0 0 6 
4 0 0 0 0 0 0 0 0 0 0 0 0 0 0 6 
4 0 0 0 5 5 5 5 5 5 5 5 5 0 0 6 
4 0 0 0 0 0 0 0 0 0 0 0 0 0 0 6 
4 0 0 0 0 0 0 0 0 0 0 0 0 0 0 6 
4 0 0 0 0 0 0 0 0 0 0 0 0 0 0 6 
7 8 8 8 8 8 8 8 8 8 8 8 8 8 8 9
