TILEMAP
48 48 							-- Size of tile map in tiles
20 20 							-- Tile size & block size
images/Celeste.png 	-- Tilesheet
16 16 								-- Number of tiles in tilesheet
116 116 116 116 116 116 116 116 116 116 116 116 116 116 116 116 19 49 34 34 36 34 34 50 50 50 50 50 51 0 0 33 34 35 33 34 34 35 49 50 50 50 34 35 0 0 0 33 
116 116 116 116 116 116 116 116 116 116 116 116 116 116 116 116 34 19 49 50 50 50 51 0 0 0 0 0 0 0 0 33 34 35 49 50 50 51 0 0 0 0 33 35 0 0 0 33 
116 116 116 116 116 116 116 116 116 116 116 116 116 116 116 116 34 34 19 23 0 0 0 0 0 0 0 0 0 0 3 33 34 34 19 23 0 0 0 0 0 0 33 35 0 0 0 33 
116 116 116 116 116 116 116 116 116 116 116 116 116 116 116 116 50 50 51 0 0 0 0 0 0 0 0 0 2 23 23 33 36 34 35 0 0 0 0 0 0 0 33 51 0 0 0 33 
116 116 116 116 116 117 118 119 120 121 122 116 116 116 116 116 19 65 66 0 0 0 0 0 0 0 0 0 20 21 18 34 34 36 35 0 0 0 0 4 0 0 68 0 0 0 0 33 
116 116 116 116 132 133 134 135 136 137 138 116 116 116 116 116 35 81 82 0 0 0 0 0 0 0 0 0 0 0 49 34 34 50 51 0 0 0 0 52 0 0 84 0 0 0 1 33 
116 116 116 116 148 149 150 150 150 153 154 116 116 116 116 116 34 18 21 21 22 0 0 0 0 0 0 0 0 0 0 33 35 0 3 0 0 0 0 68 0 0 0 0 0 0 17 34 
116 116 116 116 164 165 165 165 165 165 170 116 116 116 116 116 34 51 0 0 0 0 0 0 0 0 0 0 0 0 0 33 34 19 23 23 0 0 0 68 0 0 0 0 0 0 33 36 
116 116 116 116 116 116 116 116 116 116 116 116 116 116 116 116 35 0 0 0 0 0 0 0 0 0 0 0 0 0 0 33 34 34 18 19 0 0 0 84 0 0 0 0 0 0 49 50 
116 116 116 116 116 116 116 116 116 116 116 116 116 116 116 116 51 0 0 0 0 0 0 0 0 0 0 0 0 20 18 34 34 34 36 35 0 0 0 23 0 0 0 0 0 0 17 18 
116 116 116 116 116 116 116 116 116 116 116 116 116 116 116 116 0 0 0 0 0 0 0 1 0 0 0 0 0 0 33 34 36 34 34 35 0 0 0 52 0 0 0 0 0 20 50 34 
116 116 116 116 116 116 116 116 116 116 116 116 116 116 116 116 0 0 0 0 0 0 0 17 19 0 0 0 0 0 33 34 36 34 34 35 0 0 0 52 0 0 0 0 0 20 50 34 
116 116 116 116 116 116 116 116 116 116 116 116 116 116 116 116 0 0 0 17 19 0 0 49 51 0 0 4 4 4 33 34 0 0 49 35 0 0 0 68 0 0 0 0 0 0 0 49 
116 116 116 116 116 116 116 116 116 116 116 116 116 116 116 116 18 18 18 34 35 0 0 17 19 4 4 17 18 18 34 34 0 0 0 84 0 0 0 68 4 4 4 0 0 0 0 0 
116 116 116 116 116 116 116 116 116 116 116 116 116 116 116 116 34 36 34 34 35 4 4 33 34 18 18 34 34 34 36 34 0 0 0 0 0 0 2 33 18 18 19 0 0 0 0 0 
116 116 116 116 116 116 116 116 116 116 116 116 116 116 116 116 34 34 34 34 34 18 18 18 34 34 34 34 34 34 34 34 18 18 18 18 18 18 18 34 34 36 35 0 0 0 0 0